115 115 115 115 115 115 115 115 115 115 115 115 115 115 115 115 115 115 115 115 115 115 115 115 115 115 115 115 115 115 115 115 115 115 115 115 115 115 115 115 115 115 115 115 115 115 115 115 115 115 115 115 115 115 115 115 115 115 115 115
115 115 115 115 115 115 115 115 115 115 115 115 115 115 115 115 115 115 115 115 115 115 115 115 115 115 115 115 115 115 115 115 115 115 115 115 115 115 115 115 115 115 115 115 115 115 115 115 115 115 115 115 115 115 115 115 115 115 115 115
115 115 115 115 115 115 115 115 115 115 115 115 115 115 115 115 115 115 115 115 115 115 115 115 115 115 115 115 115 115 115 115 115 115 115 115 115 115 115 115 115 115 115 115 115 115 115 115 115 115 115 115 115 115 115 115 115 115 115 115
115 115 115 115 115 115 115 115 115 115 115 115 115 115 115 115 115 115 115 115 115 115 115 115 115 115 115 115 115 115 115 115 115 115 115 115 115 115 115 115 115 115 115 115 115 115 115 115 115 115 115 115 115 115 115 115 115 115 115 115
115 115 115 115 115 115 115 115 115 115 115 115 115 115 115 115 115 115 115 115 115 115 115 115 115 115 115 115 115 115 115 115 115 115 115 115 115 115 115 115 115 115 115 115 115 115 115 115 115 115 115 115 115 115 115 115 115 115 115 115
115 115 115 115 115 115 115 115 115 115 115 115 115 115 115 115 115 115 115 115 115 115 115 115 115 115 115 115 115 115 115 115 115 115 115 115 115 115 115 115 115 115 115 115 115 115 115 115 115 115 115 115 115 115 115 115 115 115 115 115
115 115 115 115 115 115 115 115 115 115 115 115 115 115 115 115 115 115 115 115 115 115 115 115 115 115 115 115 115 115 115 115 115 115 115 115 115 115 115 115 115 115 115 115 115 115 115 115 115 115 115 115 115 115 115 115 115 115 115 115
115 115 115 115 115 115 115 115 115 115 115 115 115 115 115 115 115 115 115 115 115 115 115 115 115 115 115 115 115 115 115 115 115 115 115 115 115 115 115 115 115 115 115 115 115 115 115 115 115 115 115 115 115 115 115 115 115 115 115 115
115 115 115 115 115 115 115 115 115 115 115 115 115 115 115 115 115 115 115 115 115 115 115 115 115 115 115 115 115 115 115 115 115 115 115 115 115 115 115 115 115 115 115 115 115 115 115 115 115 115 115 115 115 115 115 115 115 115 115 115
115 115 115 115 115 115 115 115 115 115 115 115 115 115 115 115 115 115 115 115 115 115 115 115 115 115 115 115 115 115 115 115 115 115 115 115 115 115 115 115 115 115 115 115 115 115 115 115 115 115 115 115 115 115 115 115 115 115 115 115
115 115 115 115 115 115 115 115 115 115 115 115 115 115 115 115 115 115 115 115 115 115 115 115 115 115 115 115 115 115 115 115 115 115 115 115 115 115 115 115 115 115 115 115 115 115 115 115 115 115 115 115 115 115 115 115 115 115 115 115
115 115 115 115 115 115 115 115 115 115 115 115 115 115 115 115 115 115 115 115 115 115 115 115 115 115 115 115 115 115 115 115 115 115 115 115 115 115 115 115 115 115 115 115 115 115 115 115 115 115 115 115 115 115 115 115 115 115 115 115
115 115 115 115 115 115 115 115 115 115 115 115 115 115 115 115 115 115 115 115 115 115 115 115 115 115 115 115 115 115 115 115 115 115 115 115 115 115 115 115 115 115 115 115 115 115 115 115 115 115 115 115 115 115 115 115 115 115 115 115
115 115 115 115 115 115 115 115 115 115 115 115 115 115 115 115 115 115 115 115 115 115 115 115 115 115 115 115 115 115 115 115 115 115 115 115 115 115 115 115 115 115 115 115 115 115 115 115 115 115 115 115 115 115 115 115 115 115 115 115
115 115 115 115 115 115 115 115 115 115 115 3 4 5 115 115 115 115 115 115 115 115 115 115 115 115 115 115 115 115 115 115 115 115 115 115 115 115 115 115 115 3 4 5 6 115 115 115 115 115 115 115 115 3 4 5 6 115 115 115
2 2 2 2 2 2 2 2 2 2 2 7 8 9 2 2 2 2 2 2 2 2 2 2 2 2 2 2 2 2 2 2 2 2 2 2 2 2 2 2 2 7 8 9 2 2 2 2 2 2 2 2 2 7 8 9 2 2 2 2
115 115 115 115 115 115 115 115 115 115 115 115 23 24 115 115 115 115 115 115 115 115 115 115 115 115 115 115 115 115 115 115 115 115 115 115 115 115 115 115 115 115 23 24 115 115 115 115 115 115 115 115 115 115 23 24 115 115 115 115
115 115 115 115 115 115 115 115 115 115 115 115 38 39 115 115 115 115 115 115 115 115 115 115 115 115 115 115 115 115 115 115 115 115 115 115 115 115 115 115 115 115 38 39 115 115 115 115 115 115 115 115 115 115 38 39 115 115 115 115
115 115 115 115 115 115 115 115 115 115 115 115 53 69 115 115 115 115 115 115 115 115 115 115 115 115 115 115 115 115 115 115 115 115 115 115 115 115 115 115 115 115 53 69 115 115 115 115 115 115 115 115 115 115 53 144 115 115 115 115
45 46 47 48 49 115 115 115 115 115 115 115 68 84 115 115 115 115 115 115 115 115 115 115 115 115 115 115 115 115 115 181 182 182 182 45 46 47 48 49 115 115 68 84 115 115 115 115 115 115 115 115 115 115 68 84 181 182 182 182
60 61 62 63 64 115 115 115 115 115 115 115 83 69 115 115 115 115 115 115 115 17 18 18 18 18 18 130 115 115 32 33 34 34 34 60 61 62 63 64 115 115 83 69 115 17 18 18 18 18 18 130 115 115 83 32 33 34 34 34
75 76 77 78 79 115 115 115 115 115 115 115 98 69 115 115 115 115 115 115 115 10 12 12 13 14 0 1 115 115 65 20 21 22 22 75 76 77 78 79 115 115 98 69 115 10 12 12 13 14 0 1 115 115 98 65 20 21 22 22
90 91 92 93 94 115 115 115 115 115 115 115 113 114 115 115 115 115 115 115 115 25 26 27 28 29 15 16 115 115 80 35 36 37 37 109 91 92 93 94 115 115 113 114 115 25 26 27 28 29 15 16 115 115 113 80 35 36 37 37
105 106 107 108 94 115 115 115 115 115 115 115 128 69 115 115 115 115 115 115 115 40 41 42 43 44 30 31 115 115 95 50 51 52 52 109 106 107 108 94 115 115 128 69 115 40 41 42 43 44 30 31 115 115 128 95 50 51 52 52
120 121 122 123 124 125 115 115 115 115 115 115 143 144 145 131 131 131 131 131 131 146 147 148 149 55 56 57 58 59 66 67 121 122 123 123 121 122 123 124 125 115 143 144 145 146 147 148 149 55 56 57 58 59 143 66 67 121 122 123
135 136 137 138 139 140 115 115 115 115 115 115 158 159 160 161 162 163 164 70 162 161 162 163 164 70 162 70 73 74 81 82 82 82 82 139 136 137 138 139 140 115 158 159 160 161 162 163 164 70 162 70 73 74 158 81 82 82 82 82
150 151 152 153 154 155 156 156 156 156 156 156 173 174 175 176 177 178 179 85 86 176 177 178 179 85 86 87 88 89 96 97 152 152 152 151 151 152 153 154 155 156 173 174 175 176 177 178 179 85 86 87 88 89 173 96 97 152 152 152
165 166 167 168 169 170 171 171 171 171 171 187 188 189 190 191 192 193 194 100 101 191 192 193 194 100 101 102 103 104 111 112 167 167 167 166 166 167 168 169 170 187 188 189 190 191 192 193 194 100 101 102 103 104 188 111 112 167 167 167
180 183 183 183 184 185 186 186 186 186 186 202 203 204 205 209 209 209 209 209 209 209 209 209 209 209 209 209 118 119 126 127 127 127 127 183 183 183 183 184 185 202 203 204 205 209 209 209 209 209 209 209 118 119 203 126 127 127 127 127
195 196 197 198 199 200 217 210 211 212 213 217 218 219 220 224 224 224 224 224 224 224 224 224 224 224 224 224 133 134 141 142 142 198 142 198 196 197 198 199 200 217 218 219 220 224 224 224 224 224 224 224 133 134 218 141 142 142 198 142
210 211 212 213 210 211 210 211 212 213 217 212 211 210 210 212 213 211 213 212 211 212 213 211 213 212 211 210 212 213 211 212 213 213 210 210 211 212 213 210 211 212 211 210 210 212 213 211 213 212 211 210 212 213 210 211 212 213 213 210
